##                            
##                       !    
##  """ """   """ """ ""!"!   
#"""" """ "" "" """ """  !    
##         """                
##                            
##              !             
##       """ ""!"!            
##     """ """  !             
##   """     ""               
##  "" ""     ""     """      
#""""   ""  !  ""  """ ""  !  
##       ""!"!  """"    ""!"! 
##          !      ""      !  
##                  ""        
##                   ""       
##                    """  !  
##            !         ""!"! 
##    """  ""!"!           !  
##  """ """"  !               
#""""           """           
##  ""    """  "" ""          
##   "" """ """"   ""     !   
##    """           "" ""!"!  
##      ""        !  """  !   
##       ""    ""!"!          
##   !    ""  ""  !           
#"""!"!    """"               
##   !                        
##                            
